Razon Social,Empresa,Neto Gravado,Neto No Gravado,Op. Exentas,Neto,IVA,Imp. Total
Deposito Avellaneda Sur,Galderisi Carlos Andres,227605000,127823,0,227732823,47797050,275529873
Unapa,Cooperativa De Productores Tabacaleros De Salta Ltda,75189451,0,0,75189451,7894893,83084344
Jofa,Biofarma S A,50774643,0,0,50774643,10662674,61437317
Liftvan International,Deposito Avellaneda Sur S.A.,42817255,0,0,42817255,8991625,51808880
Deposito Avellaneda Sur,Nuevo Estibaje S.A.,40092600,0,0,40092600,8419445,48512045
Jofa,Clm Nutricion S. R. L.,36739513,0,0,36739513,3857649,40597162
Mercovan Argentina,Deposito Avellaneda Sur S.A.,27890697,0,0,27890697,5857047,33747744
Hermosalta SRL,Ministerio  De Salud Publica De La Provincia De Salta,0,33215563,0,33215563,0,33215563
Jofa,Centro Ganadero Srl,22334364,0,0,22334364,4690216,27024580
Mercovan Argentina,Aires Del Sur Log Srl,5229277,0,15319015,20548292,1098146,21646438
Deposito Avellaneda Sur,El Visor S.R.L.,17025458,0,0,17025458,3575346,20600804
Liftvan International,Terminal 4  S A,14817630,0,0,14817630,3111703,17929333
Deposito Avellaneda Sur,Liftvan International Company S A C,13640688,0,682034,14322722,2864544,17187266
Deposito Avellaneda Sur,Terminales Rio De La Plata Sociedad Anonima,14065525,0,0,14065525,2953080,17018605
Deposito Avellaneda Sur,Gruas Y Autoelevadores Antog Srl,13295073,0,0,13295073,2791965,16087038
Mercovan Argentina,Cargo Logistics Exim S.R.L.,568150,0,14687425,15255575,117690,15373265
Liftvan International,Exolgan S.A.,12216829,0,0,12216829,2565533,14782362
Deposito Avellaneda Sur,Reefer Containers S.A.,11660000,0,0,11660000,2448600,14108600
Mercovan Argentina,Marina Corp S.R.L,12276000,0,0,12276000,1288320,13564320
Deposito Avellaneda Sur,Sistelcom Argentina   Srl,11173500,0,0,11173500,2346435,13519935
Deposito Avellaneda Sur,Marina Corp S.R.L,10428000,0,0,10428000,1095600,11523600
Jofa,Gallara Y Cia S.A.,9281975,0,0,9281975,1949215,11231190
Mercovan Argentina,Terminal 4  S A,8745081,0,0,8745081,1836468,10581549
Mercovan Argentina,Exolgan S.A.,8563636,0,0,8563636,1798362,10361998
Deposito Avellaneda Sur,Geurayd Luis Miguel,8264463,0,0,8264463,1735537,10000000
L A R M Argentina,Decri Comercial  Sa,8142205,0,0,8142205,1709863,9852068
El Marques,Quillotasegutex S.A.,8114136,0,0,8114136,1703968,9818104
Liftvan International,Leiria Carlos Alberto,0,8937500,0,8937500,0,8937500
Liftvan International,El Marques S A,6900000,0,0,6900000,1449000,8349000
Mercovan Argentina,Silver Freight Logistic S.R.L.,0,0,8157250,8157250,0,8157250
Deposito Avellaneda Sur,Petro Lanc S.A.,6435455,0,0,6435455,1351445,7786900
Jofa,Topigs Norsvin Argentina S.R.L.,6305173,0,0,6305173,1324086,7629259
Mercovan Argentina,Hapag-Lloyd Argentina S.R.L,483580,0,7009398,7492978,103644,7596622
Liftvan International,Rodriguez Oscar Alejandro,5515000,0,0,5515000,1158150,6673150
Unapa,Limagrain Argentina Semillas S.A,5375811,0,0,5375811,1129092,6504903
Deposito Avellaneda Sur,Tieri Augusto Javier,5081739,0,0,5081739,1067165,6148904
Liftvan International,Hapag-Lloyd Argentina S.R.L,82080,0,6044560,6126640,17784,6144424
Edelweiss Spedition,Deposito Avellaneda Sur S.A.,4995870,0,0,4995870,1049133,6045003
Liftvan International,Passerini Jorge Enrique,0,6000000,0,6000000,0,6000000
Edelweiss Spedition,Urtubey Pablo,0,5500000,0,5500000,0,5500000
Mercovan Argentina,Scuadroni Raul Enrique,4400000,0,0,4400000,924000,5324000
Viñas En Flor,"Rayen Cura Sociedad Anonima, Industrial Y Comercial S. A.",4244766,0,0,4244766,891401,5136167
Liftvan International,Silver Freight Logistic S.R.L.,180225,0,4853400,5033625,37380,5071005
Jofa,Indiv S.A.,3980960,0,0,3980960,835390,4816350
Deposito Avellaneda Sur,Garcia Nicolas Alberto,0,4472000,0,4472000,0,4472000
Deposito Avellaneda Sur,Jorge Guillermo Jesus,0,4334912,0,4334912,0,4334912
Liftvan International,Terminales Rio De La Plata Sociedad Anonima,3567660,0,0,3567660,749440,4317100
Liftvan International,Chiemese S.A.,3508840,0,59026,3567866,736856,4304722
Deposito Avellaneda Sur,Costa Norberto Genaro,3471074,0,0,3471074,728926,4200000
Liftvan International,Nuevos Ayres Cargo S.A.,0,4139600,0,4139600,0,4139600
Mercovan Argentina,Agostino Ninone Anibal Salvador,3350000,0,0,3350000,703500,4053500
Liftvan International,Padron Juan Abelardo,3334033,0,0,3334033,700147,4034180
Mercovan Argentina,Estudio Passerini S.R.L.,1306050,2440968,0,3747018,274270,4021288
Deposito Avellaneda Sur,Terminal 4  S A,3204115,0,0,3204115,672864,3876979
Deposito Avellaneda Sur,Aguirre Oliva Santiago,0,3384000,0,3384000,0,3384000
Deposito Avellaneda Sur,Pons Fernando Raul,2790090,0,0,2790090,585919,3376009
Liftvan International,Osde Organizacion De Servicios Directos Empresarios,2886599,0,0,2886599,303093,3189692
Deposito Avellaneda Sur,Carazzo Silvia Monica,0,3008389,0,3008389,0,3008389
Deposito Avellaneda Sur,Logistica Aron S.R.L,0,2978312,0,2978312,0,2978312
Deposito Avellaneda Sur,Cavodeassi Gaston Diego,2441755,0,0,2441755,512769,2954524
Viñas En Flor,Lichtenberg Ana Paula,2366807,0,0,2366807,497029,2863836
Liftvan International,Cavodeassi Gaston Diego,2351799,0,0,2351799,493878,2845677
Viñas En Flor,Medina Añi Nala Nahuel,2510220,0,0,2510220,263573,2773793
Unapa,Alfa Agroganadera S. R. L.,2220457,0,0,2220457,466295,2686752
Mercovan Argentina,Expreso Sur Srl,2200000,0,0,2200000,462000,2662000
Liftvan International,Corrugar S.A.,2128260,0,0,2128260,446935,2575195
Viñas En Flor,Mercadolibre S.R.L.,2122405,0,0,2122405,445705,2568110
Liftvan International,Transporte Y Logistica Andresito S.R.L,2100000,0,0,2100000,441000,2541000
Liftvan International,Pochat Alurralde Juan Manuel,0,2540050,0,2540050,0,2540050
Liftvan International,M Dodero Compania General De Servicios S A,2058820,0,0,2058820,432352,2491172
Viñas En Flor,Transporte La Merced S.R.L.,2000000,0,0,2000000,420000,2420000
Mercovan Argentina,Ba Comex S.A.,1960000,0,0,1960000,411600,2371600
Liftvan International,Aires Del Sur Log Srl,823632,0,1331828,2155460,172963,2328423
Deposito Avellaneda Sur,Servairex S. R. L.,1917834,0,0,1917834,402745,2320579
Nerococina,Santos Patricio Ezequiel,0,2295668,0,2295668,0,2295668
Jofa,Leselec Electricidad S. R. L.,1953526,0,0,1953526,320440,2273966
Liftvan International,Aurelia S A C I Y F,1849731,0,0,1849731,388444,2238175
Liftvan International,Sanabria Jose Saturino,1796170,0,0,1796170,377195,2173365
Deposito Avellaneda Sur,Soluciones Manplast,1749690,0,0,1749690,367435,2117125
Liftvan International,L A R M Argentina Sociedad Anonima,185658,1856579,0,2042237,38988,2081225
Liftvan International,Reino Ceramicos S.A.,1704364,0,0,1704364,357917,2062281
Liftvan International,Mediterranean Shipping Company S A,330120,1659084,0,1989204,69326,2058530
Unapa,Asociacion Mutual De Productores Tabacaleros De Salta,1686488,0,0,1686488,322455,2008943
Deposito Avellaneda Sur,Nieto Enzo Rodrigo,0,2000000,0,2000000,0,2000000
Liftvan International,Perronnet Juan Pedro,1648244,0,0,1648244,346131,1994375
Jofa,Llamas Laboratorios Y Servicios Sociedad De La Seccion Iv Lgs S. Cap I Secc Iv,1647800,0,0,1647800,346038,1993838
L A R M Argentina,Diaz Alberdi Dolores,0,1960496,0,1960496,0,1960496
Jofa,M B Energy  Sociedad De Resonsabilidad  Limitada,1588513,0,0,1588513,333588,1922101
Deposito Avellaneda Sur,Logistica Ledesma S.A.,1560000,0,0,1560000,327600,1887600
Deposito Avellaneda Sur,Medina Christian Marcelo,0,1838500,0,1838500,0,1838500
Liftvan International,Galderisi Carlos Andres,1500000,0,0,1500000,315000,1815000
Deposito Avellaneda Sur,Toledo Marcelo Sebastian,0,1800000,0,1800000,0,1800000
Liftvan International,Gimenez Diaz Cesar Oscar,0,1800000,0,1800000,0,1800000
Jofa,Mr Y Asociados S.R.L.,1450000,0,0,1450000,304500,1754500
Mercovan Argentina,Gimenez Leandro Cesar,0,1750000,0,1750000,0,1750000
Mercovan Argentina,Naon Gimenez Jose Oscar,0,1750000,0,1750000,0,1750000
Liftvan International,Gonzalez Sebastian Enrique,1440000,0,0,1440000,302400,1742400
Deposito Avellaneda Sur,Castellanos Ernesto Pablo,0,1739591,0,1739591,0,1739591
Deposito Avellaneda Sur,Adorada Srl,1417000,0,0,1417000,297570,1714570
Deposito Avellaneda Sur,Paiva Esteban Miguel,1404959,0,0,1404959,295041,1700000
Liftvan International,A.M.Mensajeria Srl,1397274,0,0,1397274,293428,1690702
Mercovan Argentina,Contreras Ruben Dario,1350000,0,0,1350000,283500,1633500
Valenzuela Ricardo Patricio,Tension Creativa Srl,1271529,0,0,1271529,267021,1538550
Liftvan International,Fernandez Marcelo Adrian,0,1500000,0,1500000,0,1500000
Liftvan International,Pais Furtado Javier Alejandro,0,1500000,0,1500000,0,1500000
Viñas En Flor,Vega Jonathan Daniel,0,1500000,0,1500000,0,1500000
Mercovan Argentina,Star Shipping Argentina Sociedad Anonima,372180,1024330,0,1396510,78157,1474667
Mercovan Argentina,Amato Daniel Alejandro,1200000,0,0,1200000,252000,1452000
Liftvan International,Rojo Maria Gabriela,1165000,0,0,1165000,244650,1409650
Liftvan International,Beraldi Ricardo Tomas,1150000,0,0,1150000,241500,1391500
Liftvan International,Edenred Argentina Sociedad Anonima,1142250,0,0,1142250,239873,1382123
Liftvan International,Martinez Pollitzer Jimena,0,1362400,0,1362400,0,1362400
Deposito Avellaneda Sur,Mercovan Argentina S.A.,1111570,0,0,1111570,233430,1345000
Deposito Avellaneda Sur,Aranda Luis Alberto,1101854,0,0,1101854,231389,1333243
Liftvan International,Martinez Eriberto Omar,0,1300000,0,1300000,0,1300000
Hermosalta SRL,Campos Eduardo Facundo,0,1295000,0,1295000,0,1295000
Liftvan International,Telmex Argentina Sa,1043799,0,0,1043799,227536,1271335
Liftvan International,Mazurkiewich Ramon Daniel,1030000,0,0,1030000,216300,1246300
Mercovan Argentina,Boscaglio Liliana Del Carmen,0,1245000,0,1245000,0,1245000
Viñas En Flor,Moya Victor Daniel,1025000,0,0,1025000,215250,1240250
Mercovan Argentina,Acrogliano Carlos Ricardo,1021723,0,0,1021723,214562,1236285
Valenzuela Ricardo Patricio,El Faro Recoleta S.R.L.,1016461,0,0,1016461,211319,1227780
Unapa,Fiani Automotores Sa,1012414,0,0,1012414,212607,1225021
Deposito Avellaneda Sur,Arnedo Jose Maria,0,1221000,0,1221000,0,1221000
Deposito Avellaneda Sur,Maqservi S R L,1002150,0,0,1002150,210452,1212602
Mercovan Argentina,Ypf Sociedad Anonima,998316,0,0,998316,209646,1207962
L A R M Argentina,Ale Alejandra Beatriz,0,1185000,0,1185000,0,1185000
Liftvan International,Estudio Bosch Abogados S.R.L.,950000,0,0,950000,199500,1149500
Viñas En Flor,Mounier Jose Luis,935000,0,0,935000,196350,1131350
Mercovan Argentina,Omint Sociedad Anonima De Servicios,17447,0,1105144,1122591,3664,1126255
Deposito Avellaneda Sur,Dale Gas Sa,1018099,0,0,1018099,106901,1125000
Deposito Avellaneda Sur,Bravo Miguel Angel,922716,0,0,922716,193770,1116486
Viñas En Flor,Transportes La Sevillanita Srl,918113,0,0,918113,192804,1110917
Liftvan International,Autopistas Urbanas S. A.,915402,0,0,915402,192234,1107636
Deposito Avellaneda Sur,Latorre Pesaje S R L,900000,0,0,900000,189000,1089000
Deposito Avellaneda Sur,Polvere Adrian Marcelo,894000,0,0,894000,187740,1081740
Mercovan Argentina,Logisa Srl,875000,0,0,875000,183750,1058750
Viñas En Flor,Frigorifico Bermejo S.A.,952795,0,0,952795,100044,1052839
Liftvan International,Cosco Shipping Lines ( Argentina ) Sa,0,0,1037740,1037740,0,1037740
Deposito Avellaneda Sur,Logistica Tinac S.A.,846648,0,0,846648,177796,1024444
Jofa,Retamoso Delia Cecilia,0,1000000,0,1000000,0,1000000
Jofa,Derivados Naturales De Frutas S.A.,0,0,1000000,1000000,0,1000000
Deposito Avellaneda Sur,Exolgan S.A.,788147,0,0,788147,165511,953658
Deposito Avellaneda Sur,Carazza Fabian Alejandro,0,950000,0,950000,0,950000
Mercovan Argentina,Baez Maria Belen,0,950000,0,950000,0,950000
Viñas En Flor,Enartis Argentina Sa,779530,0,0,779530,163030,942560
Mercovan Argentina,Papeltecnica Saic,772200,0,0,772200,162162,934362
Viñas En Flor,Distribuidora Vidt Srl,771633,0,0,771633,150875,922508
Jofa,Maderner Nestor Ruben,761983,0,0,761983,160017,922000
Liftvan International,Prosegur Activa Argentina Sa,749711,0,0,749711,157439,907150
Liftvan International,Navarro Karina Alejandra,731120,0,0,731120,153535,884655
Viñas En Flor,Feltrin S.A,730347,0,0,730347,153373,883720
Liftvan International,Aeropuertos Argentina 2000 S A,725710,0,0,725710,152080,877790
Mercovan Argentina,Transporte El Grande S. R. L.,720000,0,0,720000,151200,871200
Liftvan International,Bank S. A.,703500,0,0,703500,147734,851234
Deposito Avellaneda Sur,Carranza Eduardo Maximo,0,845920,0,845920,0,845920
Liftvan International,Telecom Argentina Sociedad Anonima,694241,0,0,694241,148287,842528
Liftvan International,Wisetech Global (Argentina) S.A.U.,688266,0,0,688266,144536,832802
Liftvan International,Murchison S A Estibajes Y Cargas Industrial Y Comercial,685980,0,0,685980,144056,830036
Deposito Avellaneda Sur,Castro Videla Maria Elena,0,828025,0,828025,0,828025
Mercovan Argentina,Ronconi Juan Ignacio,0,820000,0,820000,0,820000
Nerococina,Distribuidora El Criollo Srl,677850,0,0,677850,135733,813583
Deposito Avellaneda Sur,Lopez Leandro Leonel,0,810000,0,810000,0,810000
Mercovan Argentina,Terminales Rio De La Plata Sociedad Anonima,668560,0,0,668560,139740,808300
Deposito Avellaneda Sur,Pinturerias Sagitario S A,654694,0,0,654694,137486,792180
Liftvan International,Meriti Srl,650644,0,0,650644,136635,787279
Deposito Avellaneda Sur,Advance Shipment International S.A.,648996,0,0,648996,136289,785285
Liftvan International,Puertas Y Ventanas El Talar Aberturas S.R.L.,644628,0,0,644628,135372,780000
Hermosalta SRL,Colque Evelyn Maia Elisabeth,0,770000,0,770000,0,770000
Liftvan International,Handyway Cargo S.A.,590700,0,51007,641707,124047,765754
Mercovan Argentina,Incosa S A I C,622938,0,0,622938,130817,753755
Liftvan International,Rizzotto Roque Omar,0,747442,0,747442,0,747442
Deposito Avellaneda Sur,Equipamiento Para Empresas S.R.L.,614177,0,0,614177,128977,743154
Edelweiss Spedition,Terminal 4  S A,605220,0,0,605220,127096,732316
L A R M Argentina,Osde Organizacion De Servicios Directos Empresarios,660128,0,0,660128,69313,729441
Mercovan Argentina,Sanabria Jose Saturino,601596,0,0,601596,126335,727931
Viñas En Flor,Canatella Marcelo Pablo,600000,0,0,600000,126000,726000
Mercovan Argentina,Telecom Argentina Sociedad Anonima,583880,0,0,583880,133521,717401
Deposito Avellaneda Sur,El Jumillano S A,592223,0,0,592223,124367,716590
Edelweiss Spedition,Aires Del Sur Log Srl,588636,0,0,588636,123614,712250
Liftvan International,Odriozola Nelson Matias,0,700000,0,700000,0,700000
Mercovan Argentina,Autopistas Urbanas S. A.,568637,0,0,568637,119413,688050
Liftvan International,Autopistas Del Sol S A,538135,0,16144,554279,113009,667288
Viñas En Flor,Vinos De Argentina Asociacion Civil Para La Promocion Externa,0,665000,0,665000,0,665000
Viñas En Flor,Oxigeno Salta S.R.L.,545589,0,0,545589,114574,660163
Leoni Maria Jose,Rs4 Sociedad Anonima,545455,0,0,545455,114545,660000
Leoni Maria Jose,Medina Analia Susana,0,649825,0,649825,0,649825
Liftvan International,Prodexpo Internacional Srl,528000,10732,0,538732,110880,649612
Viñas En Flor,A & C,534613,0,0,534613,108994,643607
Valenzuela Ricardo Patricio,Nestle Argentina S A,531654,0,0,531654,111647,643301
Deposito Avellaneda Sur,Samlog S.R.L.,530000,0,0,530000,111300,641300
Liftvan International,Mis Genios S.R.L.,524301,0,0,524301,110103,634404
Viñas En Flor,Mansilla Juan,523476,0,0,523476,109931,633407
L A R M Argentina,Mastino Alejandro Martin,0,628000,0,628000,0,628000
Deposito Avellaneda Sur,Simz S. R. L.,515970,0,0,515970,108354,624324
Liftvan International,"Suc. De  Gejo Manuel, Gejo Ruben Alberto Y  Gejo Rodolfo Walter",513678,0,0,513678,107872,621550
Deposito Avellaneda Sur,Aramberry Aitor Carlos Maria,0,621500,0,621500,0,621500
BA Comex,Lakaut S.A.,509436,0,0,509436,106984,616420
Viñas En Flor,Maresca Daniela Anahi,0,610000,0,610000,0,610000
Deposito Avellaneda Sur,Fimda S.A.,500940,0,0,500940,105197,606137
Valenzuela Ricardo Patricio,Cencosud S A,503321,2579,0,505900,94334,600234
Deposito Avellaneda Sur,Mendez Arrieche Nixa Jhoseline,494701,0,0,494701,103887,598588
Liftvan International,Pussetto Salta S A,492576,0,0,492576,103441,596017
Deposito Avellaneda Sur,Contenedores Hugo Sa,488114,0,0,488114,102504,590618
De la Arena Martin,Fundacion Santa Maria,0,566000,0,566000,0,566000
Mercovan Argentina,Taller Claudio S R L,458678,0,0,458678,96322,555000
Nerococina,Keklikian Macri Ramiro,0,550000,0,550000,0,550000
Nerococina,Frigorifico Los Prados Sa,494347,0,0,494347,53044,547391
Edelweiss Spedition,Gareca Sebastian Emanuel,445954,0,0,445954,93650,539604
Liftvan International,Ocean Network Express Argentina S. A.,0,532980,0,532980,0,532980
Deposito Avellaneda Sur,Ponzi Fernando Ariel,0,525000,0,525000,0,525000
Mercovan Argentina,Huxley S.A.,426915,0,0,426915,89653,516568
Liftvan International,Fiorasi Sociedad Anonima,425219,0,0,425219,89296,514515
Leoni Maria Jose,Del Ponte Maria Julia,424450,0,0,424450,89135,513585
U-Bros,Mercadolibre S.R.L.,421844,0,0,421844,88587,510431
Mercovan Argentina,Alais Marta Ines,0,500000,0,500000,0,500000
Hermosalta SRL,Serapio Agustin Gerardo,0,490000,0,490000,0,490000
BA Comex,Mymtec Sa,402241,0,0,402241,84471,486712
Liftvan International,Pizzi Jose Luis,402000,0,0,402000,84420,486420
Viñas En Flor,Mamani Perez Victor Hugo,0,477463,0,477463,0,477463
Deposito Avellaneda Sur,Sanchez Augusto Bernardino,0,476700,0,476700,0,476700
Viñas En Flor,Expreso Moraga S.A.,389475,0,0,389475,81790,471265
Liftvan International,Autopistas De Buenos Aires (Aubasa) Sa S. A.,383147,0,0,383147,80460,463607
Nerococina,Mauro Walter Horacio,371074,0,0,371074,77926,449000
Deposito Avellaneda Sur,Seidel Romina Andrea,0,446530,0,446530,0,446530
Liftvan International,Ronconi Juan Ignacio,0,446000,0,446000,0,446000
BA Comex,Fitograf Srl,367851,0,0,367851,77249,445100
Liftvan International,Two  Libreria Srl,362338,0,0,362338,76092,438430
U-Bros,Meli Log Srl,360050,0,0,360050,75611,435661
Edelweiss Spedition,Ba Comex S.A.,360000,0,0,360000,75600,435600
Liftvan International,Aseguradora De Creditos Y Garantias S A,348553,4445,0,352998,73578,426576
Leoni Maria Jose,Bagnatti Alfredo Javier,0,424946,0,424946,0,424946
Liftvan International,Consulmay S.A.,350000,0,0,350000,73500,423500
Mercovan Argentina,Autopistas De Buenos Aires (Aubasa) Sa S. A.,349637,0,0,349637,73424,423061
Deposito Avellaneda Sur,Brumana Natalia Soledad,0,422000,0,422000,0,422000
Liftvan International,Cic Compañia Integral De Comercio S.A.,348687,0,0,348687,73224,421911
Deposito Avellaneda Sur,Dodero & Cia Srl,348614,0,0,348614,73209,421823
Liftvan International,Amx Argentina Sociedad Anonima,340160,0,0,340160,81040,421200
Hermosalta SRL,Osde Organizacion De Servicios Directos Empresarios,379032,0,0,379032,39798,418830
Mercovan Argentina,Rizzotto Roque Omar,0,414000,0,414000,0,414000
Deposito Avellaneda Sur,Yafar Adrian Maximiliano,0,412500,0,412500,0,412500
Mercovan Argentina,Leoni Maria Jose,221000,139350,0,360350,46410,406760
Liftvan International,Cencosud S A,335295,0,0,335295,70413,405708
Nerococina,Horeca Srl.,333077,0,0,333077,69946,403023
Liftvan International,Burgos Hugo Gabriel,0,400110,0,400110,0,400110
Viñas En Flor,Sabio Moreno Y Parodi  S.R.L.,328926,0,0,328926,69074,398000
Hermosalta SRL,Drogueria Capdevila S R L,328512,0,0,328512,68988,397500
De la Arena Martin,Miguelez Jose Antonio,320649,0,0,320649,67336,387985
Viñas En Flor,Cafayate Clean Sociedad Simple S. Cap I Secc Iv,318894,0,0,318894,66968,385862
Liftvan International,Elgart Reynaldo Abel Y Elgart Maria Emilia S. Cap I Secc Iv,317521,0,0,317521,66679,384200
Liftvan International,Crossracer International Sociedad Anonima,310500,0,5366,315866,65205,381071
Viñas En Flor,Marquez Gerardo Daniel,0,379000,0,379000,0,379000
Mercovan Argentina,Papaianni Maria Teresa,311562,0,0,311562,65428,376990
Deposito Avellaneda Sur,Distribuidora Idem S A,309915,0,0,309915,65082,374997
Liftvan International,Cpt Integral Sa,302272,0,0,302272,63477,365749
Edelweiss Spedition,Galderisi Carlos Andres,300000,0,0,300000,63000,363000
Deposito Avellaneda Sur,Riso Eugenio Aldo,300000,0,0,300000,63000,363000
Edelweiss Spedition,Transporte Y Logistica Andresito S.R.L,300000,0,0,300000,63000,363000
Viñas En Flor,Tpc Group Srl,300000,0,0,300000,63000,363000
Viñas En Flor,Lett Comercial S.A.,298359,0,0,298359,62655,361014
Deposito Avellaneda Sur,Raypac Srl S. R. L.,295920,0,0,295920,61650,357570
Nerococina,Segobia Martin Damian,293406,0,0,293406,61615,355021
Deposito Avellaneda Sur,Dalpra Nieva Alexis Camilo,0,353188,0,353188,0,353188
Mercovan Argentina,Alonso Maria Florencia,0,350000,0,350000,0,350000
Viñas En Flor,Gongora Sierra Gabriel Ramiro,0,349050,0,349050,0,349050
Liftvan International,Pinto Leonel Emiliano,281548,0,0,281548,59125,340673
Nerococina,Arta De Gonzalez S.R.L.,307643,0,0,307643,32303,339946
Mercovan Argentina,Prodexpo Internacional Srl,276000,5366,0,281366,57960,339326
Valenzuela Ricardo Patricio,Ratti Marisol Beatriz,298344,0,0,298344,40833,339177
De la Arena Martin,Arx Srl,278325,0,0,278325,58448,336773
Deposito Avellaneda Sur,2M Comex,276000,0,0,276000,57960,333960
Liftvan International,Cardoso Carlos Roberto,0,330000,0,330000,0,330000
Liftvan International,Fravega S A C I E I,271532,0,0,271532,57022,328554
Deposito Avellaneda Sur,Abimex S.R.L,271500,0,0,271500,57015,328515
Deposito Avellaneda Sur,Beraldi Franco,0,327750,0,327750,0,327750
Liftvan International,Asmel Sa,269171,0,0,269171,56526,325697
Mercovan Argentina,Espina Norma Adriana,0,325000,0,325000,0,325000
Liftvan International,Dorking Sociedad Anonima,279278,0,0,279278,40482,319760
Hermosalta SRL,Pharma Ligth S.R.L.,0,0,316800,316800,0,316800
Mercovan Argentina,Odriozola Nelson Matias,0,315000,0,315000,0,315000
Mercovan Argentina,Rufino Natalia,0,315000,0,315000,0,315000
Viñas En Flor,Marino Gabriela Ines,0,311650,0,311650,0,311650
Liftvan International,Soda Tejeda S R L,251653,0,0,251653,52847,304500
Edelweiss Spedition,Sorianello Vanesa Silvana,0,300000,0,300000,0,300000
Liftvan International,Sucesion De Ursic Boris Rodolfo,247934,0,0,247934,52066,300000
Liftvan International,Sorianello Vanesa Silvana,0,300000,0,300000,0,300000
Viñas En Flor,Correo Andreani Sa,243776,0,0,243776,51193,294969
Deposito Avellaneda Sur,Leoni Maria Jose,195000,51450,0,246450,40950,287400
Viñas En Flor,Molino Cerrillos Sociedad De Responabilidad Limitada,236465,0,0,236465,49180,285645
Mercovan Argentina,Cejas Camila De Los Angeles,0,285400,0,285400,0,285400
Viñas En Flor,Pena Marcelo Raul,0,285000,0,285000,0,285000
Liftvan International,United Airlines Inc.,0,5366,274634,280000,0,280000
Mercovan Argentina,United Airlines Inc.,0,5366,274634,280000,0,280000
Valenzuela Ricardo Patricio,La Optica S.A.,229587,0,0,229587,48213,277800
Deposito Avellaneda Sur,Gcr Sa,229400,0,0,229400,48174,277574
Liftvan International,Leoni Maria Jose,157000,77100,0,234100,32970,267070
Liftvan International,Coto Centro Integral De Comercializacion Sociedad Anonima,220437,0,0,220437,46292,266729
Deposito Avellaneda Sur,Camara De Depositos Fiscales Privados,0,265000,0,265000,0,265000
Viñas En Flor,Zacarias Pejinakis E Hijos Srl,213619,0,0,213619,44860,258479
Unapa,Sucesores De Roberto Saman Sociedad De Responsabilidad Limitada S. R. L.,212167,0,0,212167,44555,256722
Mercovan Argentina,Bank S. A.,211050,0,0,211050,44320,255370
Viñas En Flor,Burgos Alfonso Ariel,210744,0,0,210744,44256,255000
Viñas En Flor,Godoy Guillermo Raul,203384,0,0,203384,42711,246095
Liftvan International,Autres  S.R.L.,198709,0,0,198709,41729,240438
Viñas En Flor,Martiarena Eduardo Hector,0,240000,0,240000,0,240000
De la Arena Martin,Corralon San Lorenzo S.R.L.,198347,0,0,198347,41653,240000
De la Arena Martin,Telecom Argentina Sociedad Anonima,197199,0,0,197199,41439,238638
Deposito Avellaneda Sur,Acudir Sa,197149,0,0,197149,41401,238550
Leoni Maria Jose,Ibarra Dante Osvaldo,0,228900,0,228900,0,228900
Mercovan Argentina,Ivecam S. A.,183388,0,0,183388,38512,221900
U-Bros,Ronconi Juan Ignacio,0,220000,0,220000,0,220000
Leoni Maria Jose,Castillo Federico Andres,0,220000,0,220000,0,220000
Mercovan Argentina,E-Buyplace S. A.,175000,0,0,175000,36750,211750
Hermosalta SRL,Salgado Analia Elizabeth,0,210000,0,210000,0,210000
Valenzuela Ricardo Patricio,Operadora De Estaciones De Servicios Sa,170216,0,0,170216,35745,205961
Liftvan International,Tomaro Estefania Betiana,165620,0,0,165620,34780,200400
U-Bros,Odriozola Nelson Matias,0,200000,0,200000,0,200000
Deposito Avellaneda Sur,Fernandez Moreno Marcelo Diego,0,200000,0,200000,0,200000
Leoni Maria Jose,Fernandez Maria Gabriela,0,200000,0,200000,0,200000
Viñas En Flor,Soluciones Online Sa,162800,0,0,162800,34188,196988
Mercovan Argentina,El Amucan S.R.L,161984,0,0,161984,34016,196000
Mercovan Argentina,Lopez Y San Roman Sa,161348,0,0,161348,33883,195231
Deposito Avellaneda Sur,Maqueleva Sociedad Anonima,159300,0,0,159300,33750,193050
Viñas En Flor,Salvado Eduardo Antonio Roberto,157025,0,0,157025,32975,190000
Deposito Avellaneda Sur,Maresca Daniela Anahi,0,190000,0,190000,0,190000
Valenzuela Ricardo Patricio,Coto Centro Integral De Comercializacion Sociedad Anonima,163210,0,0,163210,24256,187466
L A R M Argentina,Dhl Express (Argentina) S.A.,18900,0,164160,183060,3968,187028
L A R M Argentina,Telecom Argentina Sociedad Anonima,150330,0,0,150330,32361,182691
Mercovan Argentina,Cabify S.A.,0,0,181616,181616,0,181616
Leoni Maria Jose,Telecom Argentina Sociedad Anonima,147282,0,0,147282,33996,181278
Liftvan International,Corredores Viales Sociedad Anonima,149135,0,0,149135,31318,180453
Liftvan International,Correa Rolando Nahuel,149029,0,0,149029,31296,180325
Liftvan International,Jara Valentin Alberto,0,180000,0,180000,0,180000
Leoni Maria Jose,Fondo De Cooperacion Tecnica Y Financiera - Cecba - Sl Y T - Ley 23.412,0,177230,0,177230,0,177230
Jofa,S E Electronica S.A.,142000,0,0,142000,29820,171820
Deposito Avellaneda Sur,De Moura Pinheiro S.A.,140000,0,0,140000,29400,169400
U-Bros,Autopistas De Buenos Aires (Aubasa) Sa S. A.,139531,0,0,139531,29302,168833
Liftvan International,Biside S. R. L.,137655,0,0,137655,28908,166563
BA Comex,Aranda Luis Alberto,137211,0,0,137211,28814,166025
Deposito Avellaneda Sur,Esadin Int'L Sa,136500,0,0,136500,28665,165165
Liftvan International,Coordinacion Ecologica Area Metropolitana Sociedad Del Estado,135051,0,0,135051,28361,163412
Hermosalta SRL,Ilusiones Srl,133967,0,0,133967,28133,162100
Liftvan International,Encode S.A.,132000,0,0,132000,27720,159720
Viñas En Flor,Gifel S.R.L.,132000,0,0,132000,27720,159720
Liftvan International,First Label S.R.L.,129394,0,0,129394,27173,156567
Mercovan Argentina,Sis Ingenieria Srl,129332,0,0,129332,27160,156492
Edelweiss Spedition,Soluciones Online Sa,127900,0,0,127900,26859,154759
Deposito Avellaneda Sur,Gomez Arizaga Walter Adrian,0,152805,0,152805,0,152805
Deposito Avellaneda Sur,Enrique Rujlin E Hijo,120000,0,0,120000,32400,152400
Jofa,Interbanking Sa,125025,0,0,125025,26255,151280
Unapa,Interbanking Sa,125025,0,0,125025,26255,151280
Liftvan International,Rosmino Y Cia  Sa,120248,0,0,120248,25252,145500
Leoni Maria Jose,Fernandez Susana Beatriz,120000,0,0,120000,25200,145200
Jofa,Jdp S. A. S.,119835,0,0,119835,25165,145000
Deposito Avellaneda Sur,Cigno Juan Horacio,0,144000,0,144000,0,144000
Viñas En Flor,Multimodal Sacia,0,0,143344,143344,0,143344
Mercovan Argentina,Fundacion Fundacion Instituto De Servicios Integrales Para El Transporte,0,137000,0,137000,0,137000
Deposito Avellaneda Sur,Petenatti Hnos Sa,111827,0,0,111827,23484,135311
Viñas En Flor,Jooma S. R. L.,110056,0,0,110056,23112,133168
Mercovan Argentina,Cma Cgm Argentina Sa,109600,0,0,109600,23290,132890
Viñas En Flor,Pascuzzo Vanina,108926,0,0,108926,22874,131800
BA Comex,Sif America Sa,106142,0,0,106142,22290,128432
Deposito Avellaneda Sur,Casas Leonardo Alberto,0,128000,0,128000,0,128000
Deposito Avellaneda Sur,Flash Pack S.R.L.,103636,0,0,103636,21764,125400
Deposito Avellaneda Sur,Petrazen S.A.,103306,0,0,103306,21694,125000
Deposito Avellaneda Sur,Andreone Andrea Fabiana,102907,0,0,102907,21610,124517
BA Comex,Soluciones Online Sa,101400,0,0,101400,21294,122694
U-Bros,Soluciones Online Sa,101400,0,0,101400,21294,122694
Nerococina,Soluciones Online Sa,101400,0,0,101400,21294,122694
Mercovan Argentina,Rodriguez Damian Rodolfo,0,120600,0,120600,0,120600
L A R M Argentina,Hageg Amina,0,119600,0,119600,0,119600
Jofa,Aerolineas Argentinas Sociedad Anonima,98384,0,0,98384,20661,119045
Liftvan International,Grimm Juan Miguel,97500,0,0,97500,20475,117975
Mercovan Argentina,Montastruc Graciela Isabel,95868,0,0,95868,20132,116000
Hermosalta SRL,Habitat Ecologico Sa,94545,0,0,94545,19854,114399
BA Comex,Telecentro S A,92990,0,0,92990,19528,112518
Mercovan Argentina,Brullo Leonardo Gabriel,0,110000,0,110000,0,110000
Winehaus,Lett Comercial S.A.,90893,0,0,90893,19087,109980
Winehaus,Playa Rosa,89256,0,0,89256,18744,108000
Deposito Avellaneda Sur,Inter American Cargo Group Sa,88725,0,0,88725,19110,107835
Nerococina,Pilatus Sa,88713,0,0,88713,18630,107343
Deposito Avellaneda Sur,First Label S.R.L.,87472,0,0,87472,18368,105840
Liftvan International,Grupo Concesionario Del Oeste Sa,87243,0,0,87243,18321,105564
Deposito Avellaneda Sur,Imas Sociedad De Responsabilidad Limitada,84767,0,0,84767,17801,102568
Viñas En Flor,Nubicom  S.R.L.,78508,0,0,78508,21197,99705
Mercovan Argentina,Compañia De Servicios En Seguridad S.R.L.,82292,0,0,82292,17281,99573
Mercovan Argentina,Administrative Processing Center Sa S. A.,81324,0,0,81324,17079,98403
De la Arena Martin,Albiero Hnos S R L,81220,0,0,81220,17056,98276
Liftvan International,Credito Y Caucion S.A. Compañia De Seguros,77280,2760,0,80040,16560,96600
L A R M Argentina,Sedafe,78834,0,0,78834,16555,95389
BA Comex,Deheza Sociedad Anonima Industrial Comercial Financiera Inmobiliaria,78568,0,0,78568,16499,95067
Deposito Avellaneda Sur,Gimenez Mendez Lucas Felipe,75999,0,0,75999,15960,91959
Liftvan International,Asociacion Argentina De Agentes De Carga Internacional,0,91556,0,91556,0,91556
El Marques,3 De Fierro Seguridad S.R.L.,75124,0,0,75124,15776,90900
Mercovan Argentina,Lopez Debora Yanina,0,90570,0,90570,0,90570
Deposito Avellaneda Sur,Sis Ingenieria Srl,73293,0,0,73293,15392,88685
Deposito Avellaneda Sur,Telecentro S A,72610,0,0,72610,15248,87858
Deposito Avellaneda Sur,Konstrutot Srl,71653,0,0,71653,15047,86700
De la Arena Martin,Estacion De Servicio San Lorenzo Chico S. R. L.,71103,0,0,71103,14932,86035
Edelweiss Spedition,Biside S. R. L.,70794,0,0,70794,14867,85661
Deposito Avellaneda Sur,Gaikowsky Karina Fernanda,70000,0,0,70000,14700,84700
BA Comex,Operadora De Estaciones De Servicios Sa,69189,0,0,69189,14530,83719
Viñas En Flor,Soda Monica Srl,66116,0,0,66116,13884,80000
Nerococina,Gomez Jose Maria,70579,0,0,70579,7411,77990
Nerococina,Verisure Argentina Monitoreo De Alarmas Sa,63683,0,0,63683,13373,77056
Mercovan Argentina,Autopistas Del Sol S A,61705,0,1851,63556,12958,76514
Ulog,4 Mar Argentina S A,62747,0,0,62747,13177,75924
Leoni Maria Jose,Alvear Palace Hotel Sa I,61570,0,0,61570,12930,74500
Viñas En Flor,Dhl Express (Argentina) S.A.,9100,0,63232,72332,1911,74243
Mercovan Argentina,Cigno Juan Horacio,0,74000,0,74000,0,74000
Mercovan Argentina,Andreone Andrea Fabiana,60520,0,0,60520,10405,70925
Mercovan Argentina,Dr Antonio D Silvestris Evaluacion Psicofisica De Los Conductores Sa,57851,0,0,57851,12149,70000
Mercovan Argentina,Easymail Sa,57426,0,0,57426,12060,69486
Mercovan Argentina,Corredores Viales Sociedad Anonima,55744,0,0,55744,11707,67451
Deposito Avellaneda Sur,Policlinica Privada Centro Medico Sarandi Sociedad Anonima,55482,0,0,55482,11651,67133
Liftvan International,Administrative Processing Center Sa S. A.,54216,0,0,54216,11386,65602
Deposito Avellaneda Sur,Megah Srl,53733,0,0,53733,11284,65017
Viñas En Flor,Peyran Juan Ricardo,53718,0,0,53718,11281,64999
Viñas En Flor,Fertel S A,53170,0,0,53170,11166,64336
Leoni Maria Jose,Operadora De Estaciones De Servicios Sa,50612,0,0,50612,10628,61240
Valenzuela Ricardo Patricio,Quion S.A.,49639,0,0,49639,10424,60063
Leoni Maria Jose,Todo Digital,49587,0,0,49587,10413,60000
Nerococina,Supermercados Mayoristas Makro Sa,49769,0,0,49769,9069,58838
Jofa,Don Dante S R L,47000,0,0,47000,9870,56870
Edelweiss Spedition,Bank S. A.,46900,0,0,46900,9849,56749
Liftvan International,Green Deco Srl,45540,0,0,45540,9563,55103
Deposito Avellaneda Sur,Libertech Srl,43387,0,0,43387,9111,52498
Viñas En Flor,Dominguez Nicolas Raul,40479,0,0,40479,8501,48980
Viñas En Flor,Abc Empaques Srl,39668,0,0,39668,8330,47998
Nerococina,Puro Norte Sa,40415,0,0,40415,5675,46090
L A R M Argentina,Colegio De Traductores Publicos De La Ciudad De Buenos Aires,0,42000,0,42000,0,42000
Unapa,Vale Eduardo Alfonso,33884,0,0,33884,7116,41000
Mercovan Argentina,Diesel Avellaneda S.A.,33586,0,0,33586,7053,40639
Deposito Avellaneda Sur,Pajares Spitzer Theo,32975,0,0,32975,6925,39900
Deposito Avellaneda Sur,Rausin Nelida Susana,32562,0,0,32562,6838,39400
L A R M Argentina,Rotelli Gaston Angel,32258,0,0,32258,6774,39032
Mercovan Argentina,Cañuelas Gas Sociedad Anonima,35114,0,0,35114,3686,38800
U-Bros,Pajares Spitzer Theo,31326,0,0,31326,6579,37905
Valenzuela Ricardo Patricio,Ndm  S.A,31066,0,0,31066,6524,37590
Nerococina,Getnet Argentina S. A. U.,31000,0,0,31000,6510,37510
Nerococina,Tepal S.A.,29895,0,0,29895,6278,36173
Mercovan Argentina,Cooperativa De Trabajo La Central Sodera Limitada,29752,0,0,29752,6248,36000
De la Arena Coll Manuel,Autopistas Urbanas S. A.,28556,0,0,28556,5997,34553
Mercovan Argentina,Delgado Ruben Dario,28135,0,0,28135,5908,34043
Deposito Avellaneda Sur,Amx Argentina Sociedad Anonima,27180,0,0,27180,6733,33913
Hermosalta SRL,Servinorte Los Nietos S.R.L.,27587,0,0,27587,5793,33380
Liftvan International,Gentile Maria Rosa,0,33000,0,33000,0,33000
Leoni Maria Jose,Asociacion Notarial Argentina Entidad Mutual,0,32800,0,32800,0,32800
Liftvan International,Tiboni Y Compañia Sa,25600,0,0,25600,5376,30976
Viñas En Flor,Libreria Integral Maya Sa,23966,0,0,23966,5033,28999
Hermosalta SRL,Cencosud S A,23657,0,0,23657,4968,28625
Valenzuela Ricardo Patricio,Crivello Hnos Sociedad Anonima,22066,0,0,22066,4634,26700
Valenzuela Ricardo Patricio,El Nuevo Emporio Sa,21650,0,0,21650,4547,26197
Unapa,Castilla Lorena Alejandra,20296,0,0,20296,4262,24558
Valenzuela Ricardo Patricio,Ure Florencia Raquel,0,23000,0,23000,0,23000
Liftvan International,Autopista Provincial Ap 01 Brigadier General Estanislao Lopez Fideicomiso,0,22500,0,22500,0,22500
U-Bros,Editorial Oceano Argentina S A S. A.,0,0,21629,21629,0,21629
Liftvan International,Venencio Nahuel Damian,0,20450,0,20450,0,20450
Valenzuela Ricardo Patricio,Corredores Viales Sociedad Anonima,16640,0,0,16640,3494,20134
Viñas En Flor,Industria Y Medicina Sa,16635,0,0,16635,3493,20128
Deposito Avellaneda Sur,Cangiano Carlos,16613,0,0,16613,3489,20102
Deposito Avellaneda Sur,Real Software Sa,15774,0,0,15774,3313,19087
Leoni Maria Jose,Autopistas Del Sol S A,14791,0,444,15235,3106,18341
De la Arena Coll Manuel,Autopistas Del Sol S A,14559,0,0,14559,3058,17617
Mercovan Argentina,Navarro Juan Manuel,15747,0,0,15747,1653,17400
Deposito Avellaneda Sur,Ypf Sociedad Anonima,13683,0,0,13683,2873,16556
Nerococina,Amx Argentina Sociedad Anonima,12359,0,0,12359,2628,14987
Nerococina,Angel Y Oscar Deli  S. A.,12670,0,0,12670,1330,14000
Leoni Maria Jose,Mouzo Ricardo,11240,0,0,11240,2360,13600
Mercovan Argentina,Rausin Nelida Susana,10744,0,0,10744,2256,13000
Deposito Avellaneda Sur,Estacion Lima  Sa,10591,0,0,10591,2224,12815
Deposito Avellaneda Sur,Operadora De Estaciones De Servicios Sa,10479,0,0,10479,2201,12680
Leoni Maria Jose,Autopistas Urbanas S. A.,10413,0,0,10413,2187,12600
Mercovan Argentina,Patriroz S.R.L.,11312,0,0,11312,1188,12500
Liftvan International,Bulonera Torcuato Srl,9701,0,0,9701,2037,11738
Nerococina,Gigantes Gourmet S.A.,9587,0,0,9587,2013,11600
Deposito Avellaneda Sur,Colafrancesco Ricardo Daniel,9512,0,0,9512,1997,11509
De la Arena Martin,Mercadolibre S.R.L.,9502,0,0,9502,1995,11497
Hermosalta SRL,Soda Ideal S R L,8595,0,0,8595,1805,10400
Deposito Avellaneda Sur,Peralta Daniel,7969,0,0,7969,1674,9643
Leoni Maria Jose,Mercadolibre S.R.L.,7430,0,0,7430,1560,8990
Valenzuela Ricardo Patricio,Autopistas Urbanas S. A.,5469,0,0,5469,1148,6617
Leoni Maria Jose,Amx Argentina Sociedad Anonima,3730,0,0,3730,785,4515
De la Arena Coll Manuel,Coordinacion Ecologica Area Metropolitana Sociedad Del Estado,2975,0,0,2975,625,3600
Valenzuela Ricardo Patricio,Mercadolibre S.R.L.,2884,0,0,2884,606,3490
De la Arena Coll Manuel,Grupo Concesionario Del Oeste Sa,2427,0,0,2427,510,2937
Leoni Maria Jose,Corredores Viales Sociedad Anonima,2080,0,0,2080,437,2517
U-Bros,Autopistas Urbanas S. A.,1881,0,0,1881,395,2276
Mercovan Argentina,Coordinacion Ecologica Area Metropolitana Sociedad Del Estado,1488,0,0,1488,312,1800
Liftvan International,Telefonica Moviles Argentina Sociedad Anonima,1128,0,0,1128,305,1433
Viñas En Flor,Payway Sau,1030,0,0,1030,216,1246
De la Arena Martin,Automovil Club Argentino,0,0,0,0,0,0
De la Arena Coll Manuel,Nss Sa,0,0,0,0,0,0
De la Arena Coll Manuel,Vtv Sud S.A.,0,0,0,0,0,0
Winehaus,Telasnet S.R.L.,0,0,0,0,0,0
De la Arena Coll Manuel,Emprendimientos Satelitales Sa,0,0,0,0,0,0
De la Arena Coll Manuel,Soluciones Online Sa,0,0,0,0,0,0
De la Arena Martin,Arte Grafico Editorial Argentino S. A.,0,0,0,0,0,0
Winehaus,Frigorifico Los Prados Sa,0,0,0,0,0,0
Viñas En Flor,Starlink Argentina S R L,0,0,0,0,0,0
De la Arena Martin,Consorcio Club De Campo El Tipal,0,0,0,0,0,0
De la Arena Coll Manuel,Fideicomiso De Administracion Grupo Yubrin,0,0,0,0,0,0
Deposito Avellaneda Sur,Starlink Argentina S R L,0,0,0,0,0,0
De la Arena Martin,Sa La Nacion,0,0,0,0,0,0
De la Arena Martin,Starlink Argentina S R L,0,0,0,0,0,0
Mercovan Argentina,Aurelia S A C I Y F,0,0,0,0,0,0
Liftvan International,Kromacolor Pinturerias S.R.L.,0,0,0,0,0,0
Liftvan International,Colegio De Traductores Publicos E Interpretes De La Provincia De Buenos Aires - Regional San Isidro,0,0,0,0,0,0
Liftvan International,Cma Cgm Argentina Sa,0,0,0,0,0,0
Liftvan International,Celso Mariano Javier,0,0,0,0,0,0
Liftvan International,Casa Pick S.A.,0,0,0,0,0,0
Leoni Maria Jose,Sa La Nacion,0,0,0,0,0,0
Leoni Maria Jose,Lulumase S.A.,0,0,0,0,0,0
Mercovan Argentina,Obispado De San Isidro,0,0,0,0,0,0
Leoni Maria Jose,Cencosud S A,0,0,0,0,0,0
Jofa,Starlink Argentina S R L,0,0,0,0,0,0
Edelweiss Spedition,Nuevos Ayres Cargo S.A.,0,0,0,0,0,0
Deposito Avellaneda Sur,Vuigner Valentin Celso Eldo,0,0,0,0,0,0
Winehaus,Zamit Felicitas,0,0,0,0,0,0
Unapa,Corteva Seeds Argentina S. R. L.,0,0,0,0,0,0
Valenzuela Ricardo Patricio,Arte Grafico Editorial Argentino S. A.,0,0,0,0,0,0
Valenzuela Ricardo Patricio,Autopistas Del Sol S A,0,0,0,0,0,0
Deposito Avellaneda Sur,Muebles Ergonomicos Srl,0,0,0,0,0,0
Valenzuela Ricardo Patricio,Grupo Concesionario Del Oeste Sa,0,0,0,0,0,0
Deposito Avellaneda Sur,Los Beltra S.R.L.,0,0,0,0,0,0
Deposito Avellaneda Sur,Kromacolor Pinturerias S.R.L.,0,0,0,0,0,0
Valenzuela Ricardo Patricio,Osde Organizacion De Servicios Directos Empresarios,0,0,0,0,0,0
Valenzuela Ricardo Patricio,Starlink Argentina S R L,0,0,0,0,0,0
Valenzuela Ricardo Patricio,Zival S Sa,0,0,0,0,0,0
Deposito Avellaneda Sur,Ferrero Ramon Erasmo,0,0,0,0,0,0
Ulog,Soluciones Online Sa,-67000,0,0,-67000,-14070,-81070
Viñas En Flor,Revestir Sa,-590700,0,0,-590700,-124045,-714745
Liftvan International,Gemez Sa,-872874,0,0,-872874,-183304,-1056178
Viñas En Flor,Galderisi Carlos Andres,-60417500,0,0,-60417500,-12687675,-73105175
