Razon Social,Mes,Neto Gravado,Neto No Gravado,Op. Exentas,Neto,IVA,Imp. Total
BA Comex,2025-01,12366339,0,0,12366339,2596931,14963269
BA Comex,2025-02,16700153,0,0,16700153,3507030,20207185
BA Comex,2025-03,9665928,0,0,9665928,2029844,11695770
BA Comex,2025-04,7629878,0,0,7629878,1602274,9232153
BA Comex,2025-05,15890050,0,0,15890050,3336908,19226957
BA Comex,2025-06,15629290,0,0,15629290,3282151,18911441
BA Comex,2025-07,16725025,0,0,16725025,3512255,20237280
BA Comex,2025-08,12342440,0,0,12342440,2591912,14934351
De la Arena Coll Manuel,2025-01,0,3500000,0,3500000,0,3500000
De la Arena Coll Manuel,2025-02,0,4000000,0,4000000,0,4000000
De la Arena Coll Manuel,2025-03,0,4000000,0,4000000,0,4000000
De la Arena Coll Manuel,2025-04,0,4000000,0,4000000,0,4000000
De la Arena Coll Manuel,2025-05,0,4338500,0,4338500,0,4338500
De la Arena Coll Manuel,2025-06,0,6164500,0,6164500,0,6162500
De la Arena Coll Manuel,2025-07,0,4338500,0,4338500,0,4338500
De la Arena Martin,2025-01,4827637,0,6242611,11070248,506902,11577150
De la Arena Martin,2025-02,0,0,24438382,24438382,0,24438382
De la Arena Martin,2025-03,19215839,0,3651244,22867083,2017663,24884745
De la Arena Martin,2025-04,2879871,0,16515801,19395672,302386,19698059
De la Arena Martin,2025-05,1179804,0,10754517,11934321,123879,12058200
De la Arena Martin,2025-06,6236730,0,14187538,20424268,654857,21079125
De la Arena Martin,2025-07,0,0,3641712,3641712,0,3641712
De la Arena Martin,2025-08,3440799,0,25898834,29339633,361284,29700917
Deposito Avellaneda Sur,2025-01,427729555,7358288,0,435087843,89823215,524911052
Deposito Avellaneda Sur,2025-02,424409750,16341690,0,440751440,89126039,529877481
Deposito Avellaneda Sur,2025-03,511376939,27740082,0,539117021,107389158,646506192
Deposito Avellaneda Sur,2025-04,710044566,1946214,0,711990780,149109360,861100145
Deposito Avellaneda Sur,2025-05,510271542,25309622,0,535581164,107157026,642738193
Deposito Avellaneda Sur,2025-06,428978503,20822423,0,449800926,90085491,539886417
Deposito Avellaneda Sur,2025-07,653777305,38176080,0,691953385,137293234,829246630
Deposito Avellaneda Sur,2025-08,614343226,4725632,0,619068858,129012088,748080948
Edelweiss Spedition,2025-01,6139168,1983200,9924020,18046388,1289225,19335613
Edelweiss Spedition,2025-02,7991838,1473360,22166310,31631508,1678393,33309901
Edelweiss Spedition,2025-03,46809438,0,44936092,91745530,9829633,101575164
Edelweiss Spedition,2025-04,-355774,0,20291784,19936010,-74549,19861461
Edelweiss Spedition,2025-05,14295248,3163139,42019425,59477812,3001093,62478905
Edelweiss Spedition,2025-06,10803772,34251482,12552986,57608240,2268863,59875917
Edelweiss Spedition,2025-07,13034193,10632616,17206801,40873610,2736272,43609882
Edelweiss Spedition,2025-08,14361628,328750,19816980,34507358,3015889,37523247
El Llamito,2025-01,15750000,0,0,15750000,3307500,19057500
El Llamito,2025-02,21240000,0,0,21240000,4460400,25700400
El Llamito,2025-03,21480000,0,0,21480000,4510800,25990800
El Llamito,2025-04,34950000,0,0,34950000,7339500,42289500
El Llamito,2025-05,34290000,0,0,34290000,7200900,41490900
El Llamito,2025-06,23780000,0,0,23780000,4993800,28773800
El Llamito,2025-07,38730000,0,0,38730000,8133300,46863300
El Llamito,2025-08,0,15912000,0,15912000,0,15912000
El Marques,2025-01,24118413,0,0,24118413,5064867,29183280
El Marques,2025-02,24387864,0,0,24387864,5121451,29509315
El Marques,2025-03,24934652,0,0,24934652,5236277,30170929
El Marques,2025-04,26305258,0,0,26305258,5524103,31829361
El Marques,2025-05,33523915,0,0,33523915,7040022,40563938
El Marques,2025-06,38351086,0,0,38351086,8053728,46404814
El Marques,2025-07,28328037,0,0,28328037,5948888,34276925
El Marques,2025-08,17719200,0,0,17719200,3721032,21440232
Hermosalta SRL,2025-01,6968679,0,16302686,23271365,757224,24028590
Hermosalta SRL,2025-02,242975,0,930000,1172975,51025,1224000
Hermosalta SRL,2025-03,121488,0,3477309,3598797,25512,3624309
Hermosalta SRL,2025-04,0,0,4261393,4261393,0,4261393
Hermosalta SRL,2025-05,0,0,2678587,2678587,0,2678587
Hermosalta SRL,2025-06,0,0,3161987,3161987,0,3161987
Hermosalta SRL,2025-07,0,0,2337098,2337098,0,2337098
Hermosalta SRL,2025-08,0,0,3478177,3478177,0,3478177
L A R M Argentina,2025-01,62308889,12050412,0,74359301,13084864,87444167
L A R M Argentina,2025-02,23758658,11915425,0,35674083,4988633,40662721
L A R M Argentina,2025-03,32164415,35096062,0,67260477,6754734,74014147
L A R M Argentina,2025-04,16625212,21381088,0,38006300,3491853,41498145
L A R M Argentina,2025-05,19943699,26136939,0,46080638,4188762,50269399
L A R M Argentina,2025-06,35801454,21092139,0,56893593,7517830,64411422
L A R M Argentina,2025-07,40482503,73196893,0,113679396,8502783,122182180
L A R M Argentina,2025-08,32948416,26886191,0,59834607,6919163,66753771
Leoni Maria Jose,2025-01,3570910,1307326,0,4878236,749891,5628127
Leoni Maria Jose,2025-02,16627231,6343914,0,22971145,3491718,28916391
Leoni Maria Jose,2025-03,14842003,11317645,0,26159648,3116821,48649034
Leoni Maria Jose,2025-04,5713062,2715338,0,8428400,1199743,25547423
Leoni Maria Jose,2025-05,19051007,19064138,0,38115145,4000711,70079324
Leoni Maria Jose,2025-06,12242400,8829801,0,21072201,2570904,45247485
Leoni Maria Jose,2025-07,29932049,25715323,0,55647372,6285730,93129070
Leoni Maria Jose,2025-08,26900375,16370163,0,43270538,5649013,79954425
Liftvan International,2025-01,226289092,0,251242064,477531156,47517798,525051098
Liftvan International,2025-02,223385746,0,337826602,561212348,46909378,608120556
Liftvan International,2025-03,270331983,0,207649791,477981774,56770361,534753223
Liftvan International,2025-04,187439270,0,385869858,573309128,39362131,612675744
Liftvan International,2025-05,273636213,0,287786749,561422962,57462244,618886363
Liftvan International,2025-06,96389022,0,119300670,215689692,20239988,235930900
Liftvan International,2025-07,244116219,0,126308111,370424330,51263310,421688877
Liftvan International,2025-08,228234574,0,133050798,361285372,45525699,406813395
Mercovan Argentina,2025-01,61288749,54014688,0,115303437,12872043,128173344
Mercovan Argentina,2025-02,136178345,88434310,0,224612655,28596127,253207702
Mercovan Argentina,2025-03,94455325,105101759,0,199557084,19832749,219390922
Mercovan Argentina,2025-04,77953782,40145706,0,118099488,16372119,134471607
Mercovan Argentina,2025-05,276731717,17867086,0,294598803,58114957,352713761
Mercovan Argentina,2025-06,-15434860,111150646,0,95715786,-3239201,92476587
Mercovan Argentina,2025-07,109027507,186669065,0,295696572,22894952,318591527
Mercovan Argentina,2025-08,88360698,37880131,0,126240829,18552623,144796134
Nerococina,2025-01,3261500,0,0,3261500,684915,3946415
Nerococina,2025-02,1800000,0,0,1800000,378000,2178000
Nerococina,2025-03,4207749,0,0,4207749,883627,5091377
Nerococina,2025-04,10310044,0,0,10310044,2165108,12475152
Nerococina,2025-05,3892000,0,0,3892000,817320,4709320
Nerococina,2025-06,12575200,0,0,12575200,2640792,15215992
Nerococina,2025-07,1749200,0,0,1749200,367332,2116532
Nerococina,2025-08,4280100,0,0,4280100,898821,5178921
U-Bros,2025-01,9315466,0,0,9315466,1956248,11271714
U-Bros,2025-02,14862173,0,0,14862173,3121047,17983220
U-Bros,2025-03,17043175,0,0,17043175,3579068,20622243
U-Bros,2025-04,13810259,0,0,13810259,2900155,16710414
U-Bros,2025-05,11600585,0,0,11600585,2436122,14036707
U-Bros,2025-06,19157715,0,0,19157715,4023093,23180807
U-Bros,2025-07,14301399,0,0,14301399,3003287,17304686
U-Bros,2025-08,14452216,0,0,14452216,3034965,17487181
Ulog,2025-01,3884156,0,0,3884156,815673,4699830
Ulog,2025-03,7444640,0,0,7444640,1563374,9008014
Ulog,2025-04,7739760,0,0,7739760,1625350,9365110
Ulog,2025-05,8044400,0,0,8044400,1689324,9733724
Ulog,2025-06,3553000,0,0,3553000,746130,4299130
Ulog,2025-07,1406500,0,0,1406500,295365,1701865
Ulog,2025-08,937750,0,0,937750,196928,1134678
Unapa,2025-05,45240000,0,0,45240000,9500400,54740400
Valenzuela Ricardo Patricio,2025-01,0,6323000,0,6323000,0,6323000
Valenzuela Ricardo Patricio,2025-02,0,6500000,0,6500000,0,6500000
Valenzuela Ricardo Patricio,2025-03,0,6500000,0,6500000,0,6500000
Valenzuela Ricardo Patricio,2025-04,0,6500000,0,6500000,0,6500000
Valenzuela Ricardo Patricio,2025-05,0,0,0,0,0,0
Valenzuela Ricardo Patricio,2025-06,13324624,0,0,13324624,2798171,16122795
Valenzuela Ricardo Patricio,2025-07,104862117,0,0,104862117,22021045,126883162
Valenzuela Ricardo Patricio,2025-08,11575644,0,0,11575644,2430885,14006529
Viñas En Flor,2025-01,47173770,3491320,0,50665090,9906476,60571566
Viñas En Flor,2025-02,64786444,0,0,64786444,13605135,78391579
Viñas En Flor,2025-03,70931460,0,0,70931460,14206271,85137731
Viñas En Flor,2025-04,114670673,7522296,0,122192969,24080879,146273848
Viñas En Flor,2025-05,63137725,0,0,63137725,13258930,76396655
Viñas En Flor,2025-06,74380409,4285156,0,78665565,15619858,94285423
Viñas En Flor,2025-07,96958493,0,0,96958493,20361238,117319731
Viñas En Flor,2025-08,76001176,0,0,76001176,15960202,91961377
