Razon Social,Mes,Neto Gravado,Neto No Gravado,Op. Exentas,Neto,IVA,Imp. Total
Aires del Sur,2025-06,143325,0,709275,852600,30098,882698
Aires del Sur,2025-07,1372232,0,12435675,13807907,288170,14096077
Aires del Sur,2025-08,6641545,0,16650843,23292388,1394723,24687112
BA Comex,2024-01,7895712,0,0,7895712,1658101,9553811
BA Comex,2024-02,9302727,0,0,9302727,1953571,11256299
BA Comex,2024-03,2752646,0,0,2752646,578054,3330701
BA Comex,2024-04,3826668,0,0,3826668,803599,4630268
BA Comex,2024-05,6084744,0,0,6084744,1277796,7362540
BA Comex,2024-06,1069195,0,0,1069195,224531,1293726
BA Comex,2024-07,1244973,0,0,1244973,261444,1506417
BA Comex,2024-08,5245858,0,0,5245858,1101630,6347487
BA Comex,2024-09,7488936,0,0,7488936,1572675,9061612
BA Comex,2024-10,3965960,0,0,3965960,832852,4798812
BA Comex,2024-11,13815058,0,0,13815058,2901163,16716219
BA Comex,2024-12,10233107,0,0,10233107,2148953,12382063
BA Comex,2025-01,12366339,0,0,12366339,2596931,14963269
BA Comex,2025-02,16700153,0,0,16700153,3507030,20207185
BA Comex,2025-03,9665928,0,0,9665928,2029844,11695770
BA Comex,2025-04,7629878,0,0,7629878,1602274,9232153
BA Comex,2025-05,15890050,0,0,15890050,3336908,19226957
BA Comex,2025-06,15629290,0,0,15629290,3282151,18911441
BA Comex,2025-07,16725025,0,0,16725025,3512255,20237280
BA Comex,2025-08,12342440,0,0,12342440,2591912,14934351
De la Arena Coll Manuel,2024-01,0,900000,0,900000,0,900000
De la Arena Coll Manuel,2024-02,0,1900000,0,1900000,0,1900000
De la Arena Coll Manuel,2024-03,0,1000000,0,1000000,0,1000000
De la Arena Coll Manuel,2024-04,0,2000000,0,2000000,0,2000000
De la Arena Coll Manuel,2024-05,0,2000000,0,2000000,0,2000000
De la Arena Coll Manuel,2024-06,0,2000000,0,2000000,0,2000000
De la Arena Coll Manuel,2024-07,0,2500000,0,2500000,0,2500000
De la Arena Coll Manuel,2024-08,0,2500000,0,2500000,0,2500000
De la Arena Coll Manuel,2024-09,0,197120,0,197120,0,197120
De la Arena Coll Manuel,2025-01,0,3500000,0,3500000,0,3500000
De la Arena Coll Manuel,2025-02,0,4000000,0,4000000,0,4000000
De la Arena Coll Manuel,2025-03,0,4000000,0,4000000,0,4000000
De la Arena Coll Manuel,2025-04,0,4000000,0,4000000,0,4000000
De la Arena Coll Manuel,2025-05,0,4338500,0,4338500,0,4338500
De la Arena Coll Manuel,2025-06,0,6164500,0,6164500,0,6162500
De la Arena Coll Manuel,2025-07,0,4338500,0,4338500,0,4338500
De la Arena Martin,2024-01,1241257,0,2391964,3633221,130332,3763553
De la Arena Martin,2024-02,0,0,1615310,1615310,0,1615310
De la Arena Martin,2024-03,0,0,817001,817001,0,817001
De la Arena Martin,2024-04,0,0,927001,927001,0,927001
De la Arena Martin,2024-06,1981846,0,8570716,10552562,208094,10760655
De la Arena Martin,2024-07,463939,0,6880620,7344559,48714,7393273
De la Arena Martin,2024-08,0,0,6648240,6648240,0,6648240
De la Arena Martin,2024-09,63851131,0,4579059,68430190,13299411,81729601
De la Arena Martin,2024-10,1000560,0,997170,1997730,105059,2102789
De la Arena Martin,2024-11,0,0,1818644,1818644,0,1818644
De la Arena Martin,2024-12,0,0,68159962,68159962,0,68159962
De la Arena Martin,2025-01,4827637,0,6242611,11070248,506902,11577150
De la Arena Martin,2025-02,0,0,24438382,24438382,0,24438382
De la Arena Martin,2025-03,19215839,0,3651244,22867083,2017663,24884745
De la Arena Martin,2025-04,2879871,0,16515801,19395672,302386,19698059
De la Arena Martin,2025-05,1179804,0,10754517,11934321,123879,12058200
De la Arena Martin,2025-06,6236730,0,14187538,20424268,654857,21079125
De la Arena Martin,2025-07,0,0,3641712,3641712,0,3641712
De la Arena Martin,2025-08,3440799,0,25898834,29339633,361284,29700917
Deposito Avellaneda Sur,2024-01,428272594,8783142,0,437055736,89937250,526992990
Deposito Avellaneda Sur,2024-02,331950191,9066320,0,341016511,69709546,410726060
Deposito Avellaneda Sur,2024-03,533420204,28749301,-196000,561973505,112039755,674013260
Deposito Avellaneda Sur,2024-04,311048522,26150109,0,337198631,65320189,402518819
Deposito Avellaneda Sur,2024-05,599002849,66039824,0,665042673,125790609,790833284
Deposito Avellaneda Sur,2024-06,351828230,1872717,0,353700947,73883938,427584883
Deposito Avellaneda Sur,2024-07,452476439,17034410,0,469510849,95020054,564530909
Deposito Avellaneda Sur,2024-08,318207370,3604927,0,321812297,66823543,388635842
Deposito Avellaneda Sur,2024-09,374524244,4857677,0,379381921,78650096,458032018
Deposito Avellaneda Sur,2024-10,439517995,4823961,0,444341956,92298785,536640738
Deposito Avellaneda Sur,2024-11,312685459,14221442,0,326906901,65663951,392570849
Deposito Avellaneda Sur,2024-12,416694834,18758644,0,435453478,87505912,522959387
Deposito Avellaneda Sur,2025-01,427729555,7358288,0,435087843,89823215,524911052
Deposito Avellaneda Sur,2025-02,424409750,16341690,0,440751440,89126039,529877481
Deposito Avellaneda Sur,2025-03,511376939,27740082,0,539117021,107389158,646506192
Deposito Avellaneda Sur,2025-04,655294566,1946214,0,657240780,137611860,794852645
Deposito Avellaneda Sur,2025-05,510271542,25309622,0,535581164,107157026,642738193
Deposito Avellaneda Sur,2025-06,428978503,20822423,0,449800926,90085491,539886417
Deposito Avellaneda Sur,2025-07,653777305,38176080,0,691953385,137293234,829246630
Deposito Avellaneda Sur,2025-08,622375726,4725632,0,627101358,130698913,757800273
Edelweiss Spedition,2024-01,167964,0,6149,174113,35273,209386
Edelweiss Spedition,2024-02,171139,0,4747073,4918212,35939,4954151
Edelweiss Spedition,2024-03,327814,0,5408418,5736232,68841,5805073
Edelweiss Spedition,2024-04,1052409,0,2021098,3073507,221007,3294514
Edelweiss Spedition,2024-05,177567,0,11141367,11318934,37289,11356223
Edelweiss Spedition,2024-06,168404,0,0,168404,35366,203770
Edelweiss Spedition,2024-07,173779,0,4410,178189,36494,214683
Edelweiss Spedition,2024-08,11309348,0,2488208,13797556,2374963,16172519
Edelweiss Spedition,2024-09,1434141,0,2271398,3705539,301170,4006709
Edelweiss Spedition,2024-10,8955482,0,3498300,12453782,1880651,14334433
Edelweiss Spedition,2024-11,2342560,0,6700,2349260,491938,2841198
Edelweiss Spedition,2024-12,238326,7300,8307370,8552996,50047,8603045
Edelweiss Spedition,2025-01,784168,1850,9260,795278,164675,959953
Edelweiss Spedition,2025-02,1977958,1242,18611005,20590205,415371,21005576
Edelweiss Spedition,2025-03,2179622,0,6003619,8183241,457720,8640962
Edelweiss Spedition,2025-04,231671,0,20291784,20523455,48650,20572105
Edelweiss Spedition,2025-05,241548,3163139,42019425,45424112,50724,45474836
Edelweiss Spedition,2025-06,787582,14742,5599856,6402180,165392,6567571
Edelweiss Spedition,2025-07,1114769,8452,4976401,6099622,234100,6333722
Edelweiss Spedition,2025-08,1888492,250,14746,1903488,396583,2300071
El Llamito,2024-01,15000,0,0,15000,3150,18150
El Llamito,2024-02,15000,0,0,15000,3150,18150
El Llamito,2024-03,15000,0,0,15000,3150,18150
El Llamito,2024-04,15000,0,0,15000,3150,18150
El Llamito,2024-05,15000,0,0,15000,3150,18150
El Llamito,2024-06,15000,0,0,15000,3150,18150
El Llamito,2024-07,215000,0,0,215000,45150,260150
El Llamito,2024-08,15000,0,0,15000,3150,18150
El Llamito,2024-09,75000,0,0,75000,15750,90750
El Llamito,2024-11,30000,0,0,30000,6300,36300
El Llamito,2024-12,15000,0,0,15000,3150,18150
El Llamito,2025-01,15000,0,0,15000,3150,18150
El Llamito,2025-02,20000,0,0,20000,4200,24200
El Llamito,2025-03,20000,0,0,20000,4200,24200
El Llamito,2025-04,30000,0,0,30000,6300,36300
El Llamito,2025-05,30000,0,0,30000,6300,36300
El Llamito,2025-06,20000,0,0,20000,4200,24200
El Llamito,2025-07,30000,0,0,30000,6300,36300
El Llamito,2025-08,0,12000,0,12000,0,12000
El Marques,2024-01,14035787,0,0,14035787,2947516,16983303
El Marques,2024-02,14954624,0,0,14954624,3140471,18095095
El Marques,2024-03,15907232,0,0,15907232,3340518,19247750
El Marques,2024-04,16588080,0,0,16588080,3483497,20071577
El Marques,2024-05,17529115,0,0,17529115,3681114,21210229
El Marques,2024-06,30410021,0,0,30410021,6386105,36796126
El Marques,2024-07,18835540,0,0,18835540,3955464,22791004
El Marques,2024-08,21190951,0,0,21190951,4450100,25641051
El Marques,2024-09,23517416,0,0,23517416,4938658,28456074
El Marques,2024-10,22281985,0,0,22281985,4679217,26961202
El Marques,2024-11,23354508,0,0,23354508,4904446,28258954
El Marques,2024-12,23558544,0,0,23558544,4947294,28505838
El Marques,2025-01,24118413,0,0,24118413,5064867,29183280
El Marques,2025-02,24387864,0,0,24387864,5121451,29509315
El Marques,2025-03,24934652,0,0,24934652,5236277,30170929
El Marques,2025-04,26305258,0,0,26305258,5524103,31829361
El Marques,2025-05,33523915,0,0,33523915,7040022,40563938
El Marques,2025-06,38351086,0,0,38351086,8053728,46404814
El Marques,2025-07,28328037,0,0,28328037,5948888,34276925
El Marques,2025-08,17719200,0,0,17719200,3721032,21440232
Hermosalta SRL,2024-01,284957,0,375930,660887,44806,705694
Hermosalta SRL,2024-02,212983,0,2248335,2461318,22363,2483681
Hermosalta SRL,2024-03,237091,0,2477910,2715001,24895,2739895
Hermosalta SRL,2024-04,197356,0,871204,1068560,41444,1110004
Hermosalta SRL,2024-05,1539322,0,4350807,5890129,170480,6060609
Hermosalta SRL,2024-06,726025,0,8465584,9191609,76233,9267841
Hermosalta SRL,2024-07,1195357,0,3077372,4272729,152066,4424795
Hermosalta SRL,2024-08,411197,0,5438453,5849650,43176,5892826
Hermosalta SRL,2024-09,4090619,204000,10639017,14933636,456068,15389704
Hermosalta SRL,2024-10,446281,0,4352360,4798641,93719,4892360
Hermosalta SRL,2024-11,10060682,0,20458715,30519397,1056372,31575769
Hermosalta SRL,2024-12,5875806,0,16175471,22051277,616960,22668237
Hermosalta SRL,2025-01,6968679,0,16302686,23271365,757224,24028590
Hermosalta SRL,2025-02,242975,0,930000,1172975,51025,1224000
Hermosalta SRL,2025-03,121488,0,3477309,3598797,25512,3624309
Hermosalta SRL,2025-04,0,0,4261393,4261393,0,4261393
Hermosalta SRL,2025-05,0,0,2678587,2678587,0,2678587
Hermosalta SRL,2025-06,0,0,3161987,3161987,0,3161987
Hermosalta SRL,2025-07,0,0,2337098,2337098,0,2337098
Hermosalta SRL,2025-08,0,0,3478177,3478177,0,3478177
Jofa,2024-06,6566465,0,0,6566465,689479,7255944
L A R M Argentina,2024-01,3649121,513670,45980,4208771,766317,4975089
L A R M Argentina,2024-02,12607924,22875531,0,35483455,2647666,38131123
L A R M Argentina,2024-03,12429334,12969263,0,25398597,2610171,28008771
L A R M Argentina,2024-04,11141187,11316192,0,22457379,2339657,24797035
L A R M Argentina,2024-05,8609659,3064136,0,11673795,1808033,13481828
L A R M Argentina,2024-06,16565684,69555912,0,86121596,3478800,89600398
L A R M Argentina,2024-07,19802395,14369610,0,34172005,4158507,38330521
L A R M Argentina,2024-08,14220508,19593316,0,33813824,2986309,36800137
L A R M Argentina,2024-09,14551752,18496660,0,33048412,3055864,36104284
L A R M Argentina,2024-10,17931262,11478599,0,29409861,3765567,33175431
L A R M Argentina,2024-11,14245051,11285794,0,25530845,2991463,28522307
L A R M Argentina,2024-12,39129043,87533392,0,126662435,8217097,134879533
L A R M Argentina,2025-01,62308889,12050412,0,74359301,13084864,87444167
L A R M Argentina,2025-02,22083578,11915425,0,33999003,4637543,38636551
L A R M Argentina,2025-03,27901835,27151384,0,55053219,5859378,60912604
L A R M Argentina,2025-04,16726036,10124284,0,26850320,3512466,30362778
L A R M Argentina,2025-05,19768349,17159019,0,36927368,4151354,41078721
L A R M Argentina,2025-06,32910054,21092139,0,54002193,6911110,60913302
L A R M Argentina,2025-07,35166390,63380568,0,98546958,7384943,105931902
L A R M Argentina,2025-08,32948416,26886191,0,59834607,6919163,66753771
Leoni Maria Jose,2024-01,48749,5038626,0,5087375,10237,8906322
Leoni Maria Jose,2024-02,3064227,826320,0,3890547,643489,10882785
Leoni Maria Jose,2024-03,9992960,16064084,0,26057044,2098521,85259753
Leoni Maria Jose,2024-04,6274224,8858964,0,15133188,1317589,31114603
Leoni Maria Jose,2024-05,30880039,31065822,0,61945861,6484810,181677346
Leoni Maria Jose,2024-06,13337512,8789211,0,22126723,2800878,37608711
Leoni Maria Jose,2024-07,16609732,14259173,0,30868905,3488045,68849814
Leoni Maria Jose,2024-08,19517048,9973429,0,29490477,4098580,71086004
Leoni Maria Jose,2024-09,15343846,6811702,0,22155548,3222208,27907653
Leoni Maria Jose,2024-10,14778382,9847237,0,24625619,3103460,49844933
Leoni Maria Jose,2024-11,17869132,11025640,0,28894772,3752518,55972479
Leoni Maria Jose,2024-12,26872278,23597675,0,50469953,5643178,81155565
Leoni Maria Jose,2025-01,3570910,1307326,0,4878236,749891,5628127
Leoni Maria Jose,2025-02,16627231,6343914,0,22971145,3491718,28916391
Leoni Maria Jose,2025-03,14842003,11317645,0,26159648,3116821,48649034
Leoni Maria Jose,2025-04,5713062,2715338,0,8428400,1199743,25547423
Leoni Maria Jose,2025-05,19051007,19064138,0,38115145,4000711,70079324
Leoni Maria Jose,2025-06,12242400,8829801,0,21072201,2570904,45247485
Leoni Maria Jose,2025-07,29932049,25715323,0,55647372,6285730,93129070
Leoni Maria Jose,2025-08,20323805,13106187,0,33429992,4267999,57496851
Liftvan International,2024-01,55073762,0,20063206,75136968,11565490,86702458
Liftvan International,2024-02,61984531,0,15085185,77069716,13016752,90086468
Liftvan International,2024-03,36285333,0,58562935,94848268,7619920,102468189
Liftvan International,2024-04,79245730,0,19419146,98664876,16641603,115306479
Liftvan International,2024-05,65325930,0,4517776,69843706,13718446,83562150
Liftvan International,2024-06,67040563,0,99281758,166322321,14078519,180400839
Liftvan International,2024-07,67399677,0,24560008,91959685,14153933,106113618
Liftvan International,2024-08,126736456,0,55791158,182527614,26614655,209142268
Liftvan International,2024-09,90896518,0,15215299,106111817,19088270,125200086
Liftvan International,2024-10,126532787,0,10831758,137364545,26571890,163936435
Liftvan International,2024-11,221039248,0,78980903,300020151,46418245,346438393
Liftvan International,2024-12,115461906,0,8242898,123704804,24247002,147951806
Liftvan International,2025-01,192059552,0,75900856,267960408,40332503,308292913
Liftvan International,2025-02,166461936,0,35516620,201978556,34957004,236935560
Liftvan International,2025-03,177750611,0,47241185,224991796,37327629,262319427
Liftvan International,2025-04,145428816,0,216239546,361668362,30540050,392208423
Liftvan International,2025-05,246986601,0,15922120,262908721,51867185,314775909
Liftvan International,2025-06,30289806,0,46037139,76326945,6360859,82687805
Liftvan International,2025-07,194687213,0,35523072,230210285,40884315,271094598
Liftvan International,2025-08,171188905,0,19423618,190612523,33545597,224158123
Mercovan Argentina,2024-01,44497146,22517210,0,67014356,9344399,76358754
Mercovan Argentina,2024-02,44708223,41317900,0,86026123,9388727,95414849
Mercovan Argentina,2024-03,32468322,26587,0,32494909,6818348,39313257
Mercovan Argentina,2024-04,51704121,29139974,0,80844095,10857865,91701959
Mercovan Argentina,2024-05,39408057,612232,0,40020289,8275694,48295984
Mercovan Argentina,2024-06,68561506,5900065,0,74461571,14397913,88859484
Mercovan Argentina,2024-07,34894159,29020504,0,63914663,7327772,71242435
Mercovan Argentina,2024-08,65446726,39030766,0,104477492,13743813,118221305
Mercovan Argentina,2024-09,75149322,82483864,0,157633186,15781357,173414541
Mercovan Argentina,2024-10,28968605,3031810,0,32000415,6083406,38083822
Mercovan Argentina,2024-11,38362886,30809187,0,69172073,8056206,77228278
Mercovan Argentina,2024-12,81693091,19476446,0,101169537,17155555,118325089
Mercovan Argentina,2025-01,44632764,24864701,0,69497465,9372881,78870344
Mercovan Argentina,2025-02,74411269,14143843,0,88555112,15626365,104181476
Mercovan Argentina,2025-03,65222625,37015288,0,102237913,13696745,115934659
Mercovan Argentina,2025-04,41148290,920399,0,42068689,8641142,50709831
Mercovan Argentina,2025-05,103545046,2270310,0,105815356,21744461,127559818
Mercovan Argentina,2025-06,48822699,45560048,0,94382747,10252767,104635516
Mercovan Argentina,2025-07,9080606,2867649,0,11948255,1906925,13855183
Mercovan Argentina,2025-08,43507397,2849799,0,46357196,9136551,55493751
Nerococina,2024-02,394449,0,0,394449,82834,477283
Nerococina,2024-03,7058250,0,0,7058250,1482232,8540482
Nerococina,2024-04,777460,0,0,777460,163267,940727
Nerococina,2024-06,2405100,0,0,2405100,505071,2910171
Nerococina,2024-07,14885500,0,0,14885500,3125955,18011455
Nerococina,2024-08,1282150,0,0,1282150,269252,1551402
Nerococina,2024-09,2651824,0,0,2651824,556883,3208707
Nerococina,2024-10,17413980,0,0,17413980,3656936,21070916
Nerococina,2024-11,23740555,0,0,23740555,4985517,28726072
Nerococina,2024-12,1500000,0,0,1500000,315000,1815000
Nerococina,2025-01,3261500,0,0,3261500,684915,3946415
Nerococina,2025-02,1800000,0,0,1800000,378000,2178000
Nerococina,2025-03,4207749,0,0,4207749,883627,5091377
Nerococina,2025-04,10310044,0,0,10310044,2165108,12475152
Nerococina,2025-05,3892000,0,0,3892000,817320,4709320
Nerococina,2025-06,12575200,0,0,12575200,2640792,15215992
Nerococina,2025-07,1749200,0,0,1749200,367332,2116532
Nerococina,2025-08,4280100,0,0,4280100,898821,5178921
U-Bros,2024-01,4616651,0,0,4616651,969496,5586147
U-Bros,2024-02,13076776,0,0,13076776,2746124,15822901
U-Bros,2024-03,10074745,0,0,10074745,2115692,12190436
U-Bros,2024-04,7219624,0,0,7219624,1516121,8735745
U-Bros,2024-05,6642700,0,0,6642700,1394967,8037667
U-Bros,2024-06,17223645,0,0,17223645,3616961,20840606
U-Bros,2024-07,6887655,0,0,6887655,1446408,8334063
U-Bros,2024-08,9548342,0,0,9548342,2005152,11553494
U-Bros,2024-09,14635106,0,0,14635106,3073364,17708470
U-Bros,2024-10,7961272,0,0,7961272,1671868,9633139
U-Bros,2024-11,9734272,0,0,9734272,2044197,11778470
U-Bros,2024-12,8374641,0,0,8374641,1758675,10133316
U-Bros,2025-01,9315466,0,0,9315466,1956248,11271714
U-Bros,2025-02,14862173,0,0,14862173,3121047,17983220
U-Bros,2025-03,17043175,0,0,17043175,3579068,20622243
U-Bros,2025-04,13810259,0,0,13810259,2900155,16710414
U-Bros,2025-05,11600585,0,0,11600585,2436122,14036707
U-Bros,2025-06,19157715,0,0,19157715,4023093,23180807
U-Bros,2025-07,14301399,0,0,14301399,3003287,17304686
U-Bros,2025-08,14452216,0,0,14452216,3034965,17487181
Ulog,2024-01,5678169,0,0,5678169,1192415,6870584
Ulog,2024-02,8542884,0,0,8542884,1794005,10336889
Ulog,2024-04,2359132,0,0,2359132,495417,2854549
Ulog,2024-05,9791198,0,0,9791198,2056151,11847349
Ulog,2024-07,920640,0,0,920640,193334,1113974
Ulog,2024-08,1255418,0,0,1255418,263638,1519056
Ulog,2024-09,3403941,0,0,3403941,714827,4118770
Ulog,2024-11,19139577,0,0,19139577,4019311,23158888
Ulog,2024-12,5993823,0,0,5993823,1258704,7252527
Ulog,2025-01,3884156,0,0,3884156,815673,4699830
Ulog,2025-03,7444640,0,0,7444640,1563374,9008014
Ulog,2025-04,7739760,0,0,7739760,1625350,9365110
Ulog,2025-05,8044400,0,0,8044400,1689324,9733724
Ulog,2025-06,3553000,0,0,3553000,746130,4299130
Ulog,2025-07,1406500,0,0,1406500,295365,1701865
Ulog,2025-08,937750,0,0,937750,196928,1134678
Unapa,2024-02,8278800,0,0,8278800,869274,9148074
Unapa,2024-03,17544200,0,0,17544200,1842141,19386341
Unapa,2024-04,2429173,0,0,2429173,405862,2835035
Unapa,2024-05,241090,0,0,241090,50629,291719
Unapa,2024-07,1421200,0,0,1421200,298452,1719652
Unapa,2024-10,1370200,0,0,1370200,287742,1657942
Unapa,2025-05,45240000,0,0,45240000,9500400,54740400
Valenzuela Ricardo Patricio,2024-01,0,2300000,0,2300000,0,1150000
Valenzuela Ricardo Patricio,2024-02,0,1150000,0,1150000,0,1150000
Valenzuela Ricardo Patricio,2024-03,0,1150000,0,1150000,0,1150000
Valenzuela Ricardo Patricio,2024-04,0,1050000,0,1050000,0,1050000
Valenzuela Ricardo Patricio,2024-05,0,1050000,0,1050000,0,1050000
Valenzuela Ricardo Patricio,2024-07,0,5500000,0,5500000,0,5500000
Valenzuela Ricardo Patricio,2024-08,0,5550000,0,5550000,0,5550000
Valenzuela Ricardo Patricio,2024-09,0,5500000,0,5500000,0,5500000
Valenzuela Ricardo Patricio,2024-10,0,5550000,0,5550000,0,5550000
Valenzuela Ricardo Patricio,2024-11,0,5550000,0,5550000,0,5550000
Valenzuela Ricardo Patricio,2024-12,0,5550000,0,5550000,0,5550000
Valenzuela Ricardo Patricio,2025-01,0,6323000,0,6323000,0,6323000
Valenzuela Ricardo Patricio,2025-02,0,6500000,0,6500000,0,6500000
Valenzuela Ricardo Patricio,2025-03,0,6500000,0,6500000,0,6500000
Valenzuela Ricardo Patricio,2025-04,0,6500000,0,6500000,0,6500000
Valenzuela Ricardo Patricio,2025-05,0,0,0,0,0,0
Valenzuela Ricardo Patricio,2025-06,13324624,0,0,13324624,2798171,16122795
Valenzuela Ricardo Patricio,2025-07,104862117,0,0,104862117,22021045,126883162
Valenzuela Ricardo Patricio,2025-08,11575644,0,0,11575644,2430885,14006529
Viñas En Flor,2024-01,24935464,0,0,24935464,5236461,30171925
Viñas En Flor,2024-02,40877105,4560,0,40881665,8584185,49465850
Viñas En Flor,2024-03,58160384,0,0,58160384,12213677,70374061
Viñas En Flor,2024-04,41632192,-4560,0,41627632,8742764,50370395
Viñas En Flor,2024-05,96671541,0,0,96671541,20301029,116972570
Viñas En Flor,2024-06,65126359,0,0,65126359,13676526,78802885
Viñas En Flor,2024-07,69376384,8681,0,69385065,14569062,83954127
Viñas En Flor,2024-08,135727552,26400,0,135753952,28502797,164256748
Viñas En Flor,2024-09,50934551,0,0,50934551,10696260,61630811
Viñas En Flor,2024-10,66926009,0,0,66926009,14054478,80980486
Viñas En Flor,2024-11,75486467,0,0,75486467,15852154,91338622
Viñas En Flor,2024-12,47410352,0,0,47410352,9956168,57366520
Viñas En Flor,2025-01,47173770,3370,0,47177140,9906476,57083616
Viñas En Flor,2025-02,64786444,0,0,64786444,13605135,78391579
Viñas En Flor,2025-03,70931460,0,0,70931460,14206271,85137731
Viñas En Flor,2025-04,114670673,7004,0,114677677,24080879,138758556
Viñas En Flor,2025-05,63137725,0,0,63137725,13258930,76396655
Viñas En Flor,2025-06,74380409,3604,0,74384013,15619858,90003871
Viñas En Flor,2025-07,96958493,0,0,96958493,20361238,117319731
Viñas En Flor,2025-08,76001176,0,0,76001176,15960202,91961377
Winehaus,2024-01,203400,0,0,203400,42714,246114
Winehaus,2024-02,1247060,0,0,1247060,261883,1508943
Winehaus,2024-04,522840,0,0,522840,109796,632636
Winehaus,2024-07,332640,0,0,332640,69854,402494
Winehaus,2024-08,2057053,0,0,2057053,431981,2489034
Winehaus,2024-09,104544,0,0,104544,21954,126498
Winehaus,2024-10,0,0,0,0,0,0
